병무청_관할,결핵환자수,신환자수,재치료자수,시군구,신환자_비율
기타,17923,14412,3511,1,80.41
경인청,5023,3992,1031,2,79.47
서울청,3012,2383,629,1,79.12
부산울산청,2594,2068,526,3,79.72
대구경북청,2281,1910,371,2,83.74
광주전남청,1411,1150,261,2,81.5
대전충남청,1300,1040,260,3,80.0
전북청,731,608,123,1,83.17
강원영동청,728,577,151,1,79.26
충청북도청,605,489,116,1,80.83
제주청,238,195,43,1,81.93
